"","X0","X1","X2","X3","X4","X5","X6","X7","X8"
"X0",0,0,0,0,0,0,1,0,0
"X1",0,0,0,0,1,0,0,0,0
"X2",0,0,0,0,0,0,0,0,0
"X3",0,0,0,0,0,0,0,0,0
"X4",0,1,0,0,0,0,0,0,0
"X5",0,0,0,0,0,0,0,0,0
"X6",1,0,0,0,0,0,0,0,0
"X7",0,0,0,0,0,0,0,0,0
"X8",0,0,0,0,0,0,0,0,0
